121213000000000000000000000000000000000000000000000000000000000000000000000000000000000000000000000000000000000000000000000000000000000000000000000000000000000000000000000000111212
121213000000000000000000000000000000000000000000000000000000000000000000000000000000000000000000000000000000000000000000000000000000000000000000000000000000000000000000000000111212
1212130000000000000000000000000000000000000000000000000000001a1b1c1d1e1f0000000000000000001a1b1c1d1e1f000000000000000000000000000000000000000000000000000000000000000000000000111212
1212130024000000000000000000000000000000000000000000000000002a2b2c2d2e2f0000000000000000002a2b2c2d2e2f000000000000000040414141414141414141420000464747474800000000000000000000111212
12121300000000000000000000000000000000000000000000aaabac00003a3b18193e3f000000adaeaf0000003a3b3c3d3e3f00000000c5c6c70050a0a1767751a2a37677520000566557645800000000000000000000111212
12121300000000000000000000000000000000000000000000babbbc00004a4b28294e4f000000bdbebf0000004a4b4c4d4e4f000000d4d5d6d70050b0b1868751b2b38687520000565757575800000000000000000000111212
121213000000000000000000000000000000000000000a0b0b0bcb0b0b0c5a5b5c5d5e5f0a0b0b0bce0b0b0b0c5a5b5c5d5e5f0a0c00e4e5e6e70050515196975151519697520000565774755840414141420000000000111212
1212140202020202020202020202020202020232353032353130323433333035313431333534323233313431303534323031353434333035323134313233303430343432313435005657848558506c516e520000000000111212
121212121212121212121212121212121212121212121212121212121212121212121212121212121212121212121212121212121212121212121212121212121212121212121300565794955850515151520000000000111212
121212121212121212121212121212121212121212121212121212121212121212121212121212121212121212121212121212121212121212121212121212121212121212121300434444444550707151520000000000111212
121212121212121212121212121212121212121212121212121212121212121212121212121212121212121212121212121212121212121212121212121212121212121212121300536b546f5550808151520000000000111212
121212121212042222222222222222222222222222222222222222222222222222222222222222222222222222222222222222222222222222222222222222222222222222222300535454545550909151520000000000111212
121212121204230000000000000000000000000000000000000000000000000000000000000000000000000000000000000000000000000000000000000000000000000000000000537273545546474747480000000000111212
12121212042300000000000000000000000000000000000000000000a7a8a900000000000000000000000000000000000000000000000000000000000000000000000000000000005382835455566c576d580000000000111212
121212042300000000000000000000000000000000000000001a1b1cb7b8b900000000000000001a1b1c1d1e1f000000000000000000000000000000000000000000000000000000539293545556575757580000000000111212
121204230000000000000000000000000000000000000000002a2b2c2d2e2f00000000000000002a2b2c2d2e2f000000000000000000000000000000000000000000000000000000404141414256747557580000000000111212
12121300000000000000000000000000000000dadbdc0000003a3b3c3d3e3f00000000000000003a3b3c3d3e3f0000dddedf00000000000000000000000000000000000000000000506851665256848557580000000000111212
12121300000000000000000000000000000000eaebec00000016174c4d4e4f00000000000000004a4b4c494e4f0000edeeef00000000000000000000000000000000000000000000505151515256949557580000000000111212
1212130000000000000000070809000000000a0bfb0b0b0b0c5a5b5c5d5e5f0d360e390e360e0f5a5b5c595e5f0a0b0bfe0b0b0c000000000d37383939370e0f0000000000000000505170715243444444444500000000111212
121213000000000000000000000000000000333132353430313033343133333531323435303435303533353433333335323132333233310202020202020202020202030000000000505180815253545454545500000000111212
121213000000000000000000000000000000111212121212121212121212121212121212121212121212121212121212121212121212121212121212121212121212130000000000505190915253547273545500000000111212
121214020202020203000000000000000000111212121212121212121212121212121212121212121212121212121212121212121212121212121212121212121212140300004647474747474853548283615543444500111212
1212121212121212130000000000000000001112121212121212121212121212121212121212121212121212121212121212121212121212121212121212121212042223000056575757575758535492935455536a5500111212
12121212120422222300000103000000000021222222222222222222222222222222222222222222222222222222222222222222222222222222222222222222222300000000566f576257655840414141414253545500111212
121212120423000000000021230000000000000000000000000000000000000000000000000000000000000000000000000000000000000000000000000000000000000000005657575757575850a4a5767752536e5500111212
121212042300000000000000000000004041414142434444444546474747484041414142434444444546474747484041414142000000000000000000000000000000000040414141425769575850b4b586875253545500111212
121204230000000000000000000000005064516552535454545556575757585064516552535454545556575757585064516552000000000000000000000000000000000050645165525757575850515196975253545500111212
121213000000000000000000000000005051515152535454545556575757585051515152535454545556575757585051515152000043444444444445000000000000000050515151525763574041414141414141414200111212
121213000000000000000000c5c6c700507071665253727354555657747558507071665253727354555657747558507071665200005372735454545500c0c1c200000000507071665257575750767778797a7b7c7d5200111212
1212130000000000000000d4d5d6d700508081515253828354555657848558508081515253828354555657848558508081515200005382836954665500d0d1d2d3000000508081515257c8c950868788898a8b8c8d5200111212
1212130000000000000000e4e5e6e700509091515253929354555657949558509091515253929354555657949558509091515200005392935454545500e0e1e2e3000000509091515257d8d950969798999a9b9c9d5200111212
121214020202020202020202023232323232323232323232323232323232323232323232323232323232323232323232323232323232323232323232323232323232323232323232323232323232323232323232323202151212
121212121212121212121212121212121212121212121212121212121212121212121212121212121212121212121212121212121212121212121212121212121212121212121212121212121212121212121212121212121212
121212121212121212121212121212121212121212121212121212121212121212121212121212121212121212121212121212121212121212121212121212121212121212121212121212121212121212121212121212121212

image image:terrain
