1212121212121212121212042223000000000000000000000000000000000000000000000000000000000000000000000000000000000000000000000000000000000000000000000000000000000011
1212121212121212120422230000000000000000000000000000000000000000000000000000000000000000000000000000000000000000000000000000000000000000000000000000000000000011
1212121212121204222300000000000000000000000000000000000000000000000000000000000000000000000000000000000000000000000000000000000000000000000000000000000000000011
1212121212042223000000000000000000000000000000000000000000000000000000000000000000000000000000000000000000000000000000000000000000000000000000000000000000000011
1212120422230000000000000000000000000000000000000000000000000000000000000000000000000000000000000000000000000000000000000000000000000000000000000000000000000115
1212042300000000000000000000000000000000000000000000000000000000000000000000000000000000000000000000000000000000000000000000000000000000000000000000000000001112
1204230000000000000000000000000000000000000000000000000000000000000000000000000000000000000000000000000000000000000000000000000000000000000000000000000000011512
0423000000000000000000000000000000000000000000000000000000000000000000000000000000000000000000000000000000000000000000000000000000000000000000000000000001151212
130000000000000000000000000000000000000000000a0b0b0b0b0b0b0c000000000000000a0b0b0b0b0b0b0c000000000000000a0b0b0b0b0c000000000000000a0b0b0b0c00000000010215121212
1300000000000000000000000000000000000030353235343333323232343532353234353332343435333532353333343233333533323334333533353533323233323432333331010202151212121212
1300000000000000000001020202030000000000000000000000000000000000000000000000000000000000000000000000000000000000000000000000000000000000000000210512121212121212
1300000000000000000011121212130000000000000000000000000000000000000000000000000000000000000000000000000000000000000000000000000000000000000000001112121212121212
1402030000000001020215121212130000000000000000000000000000000000000000000000000000000000000000000000000000000000000000000000000000000000000000002105121212121212
1212130000000021220512121212130000000000000000000000000000000000000000000000000000000000000000000000000000000000000000000000000000000000000000000011121212121212
121213000000000000210512121213000000000000000000001a1b1c1d1e1f00000000000000001a1b1c1d1e1f000000000000001a1b1c1d1e1f00000000000000000000000000000021051212121212
121214020300000000002122222223000000000000000000002a2b2c2d2e2f00000000000000002a2b2c2d2e2f000000000000002a2b2c2d2e2f00000000000000000000000000000000111212121212
121212121300000000000000000000000000000000000000003a3b3c3d3e3f00000000000000003a3b3c3d3e3f000000000000003a3b3c3d3e3f00000000000000000000000000000000210512121212
121212121300000000000000000000000000000000000000004a4b4c4d4e4f00000000000000004a4b4c4d4e4f000000000000004a4b4c4d4e4f00000000000000000000000000000000002122222205
12121204230000000000000000000000000a0b0b0b0b0b0b0c5a5b5c5d5e5f0a0b0b0b0b0b0b0c5a5b5c5d5e5f0a0b0b0b0b0b0c5a5b5c5d5e5f0a0b0b0b0c0000000000000000000000000000000011
1212042300000000000000000000010330353432353235343532333333333334353434353232343435353234353434353434353334333432323535333433353434353100000000000000000000000011
1204230000000000000007090000212300000000000000000000000000000000000000000000000000000000000000000000000000000000000000000000000000000000000000000000000000000011
0423000000000000000000000000000000000000000000000000000000000000000000000000000000000000000000000000000000000000000000000000000000000000000000000000000000000011
1300000000000000000000000000000000000000000000000000000000000000000000000000000000000000000000000000000000000000000000000000000000000000000000000000000000000011
1300000043444444454041414142000000434444444546474747484041414142464747474800000040414141424344444445404141414200000000000000000000000000000000000000000000010215
130000005366546355506c516e520000005361546e5556665767585067516552566d5763580000005061516852536e546a55506e516c5200000000000000000000000000000000000000000000111212
1300000053545454555051515152000000535454545556575757585051515152565757575800000050515151525354545455505151515200000040414141414141414141420000000000000102151212
1403000053727354555070715152000000537273545556747557585070715152567475575800000050707151525372735455507071515200000050515151515151515151520000000000001112121212
1213000053828364555080816952000000538283625556848564585080816f525684856e580000005080816f5253828366555080816b5200000050515151515151515151520000010202021512121212
1213000053929354555090915152000000539293545556949557585090915152569495575800000050909151525392935455509091515200000050515151515151515151520000111212121212121212
1213303432343533353433343235353334323534333235333433343233323233353334343535323532323434353435323533333535323435353532353434323434343334353101151212121212121212

image image:terrain
