00000000000000000000000000000000000000000000000000000000000000000000000000000000
00000000000000000000000000000000000000000000000000000000000000000000000000000000
00000000000000000000000000000000000000000000000000000000000000000000000000000000
00000000000000000000000000000000000000000000000000000000000000000000000000000000
00000000000000000000000000000000000000000000000000000000000000000000000000000000
00000000000000000000000000000000000000000000000000000000000000000000000000000000
00000000000000000000000000000000000000000000000000000000000000000000000000000000
00000000000000000000000000000000000000000000000000000000000000000000000000000000
00000000000000000000000000000000000000000000000000000000000000000000000000000000
00000000000000000000000000000000000000000000000000000000000000000000000000000000
00000000000000000000000000000000000000000000000000000000000000000000000000000000
00000000000000000000000000000000000000000000000000000000000000000000000000000000
00000000000000001a1b1c1d1e1f0000000000000000000000000000000000000000000000000000
00000000000000002a2b2c2d2e2f0000000000000000000000000000000000000000000000000000
00000000000000003a3b3c3d3e3f0000000000000000000000000000000000000000000000000000
00000000000000004a4b4c4d4e4f0000000000000000000000000000000000000000000000000000
00000000000000005a5b5c5d5e5f0000000000000000000000000000000000000000000000000000
00000000003032333534353332343235310000000000000000000000000000000000000000000000
00000000000102020202020202020202030000000000000000000000000000000000000000000000
00000000001112121212121212121212140202030000000000000000000000000000000000000000
00000000002122222222222222222222222222230000000000000000000000000000000000000000
00000000000000000000000000000000000000000000000000000000000000000000000000000000
00000000000000000000000000000000000000000000000000000000000000000000000000000000
00000000434444444540414141420000000000000000000000000000000000000000000000000000
000000005366546355506c516e5200000000000000001a1b1c1d1e1f000000000000000000000000
000000005354545455505151515200000000000000002a2b2c2d2e2f000000000000000000000000
000000005372735455507071515200000000000000003a3b3c3d3e3f000000000000000000000000
000000005382836455508081695200000000000000004a4b4c4d4e4f000000000000000000000000
000000005392935455509091515200000a0b0b0b0c005a5b5c5d5e5f000000000000000000000000
35343534323435333534333432353535343434353435353533353232323232333533343435353233

image image:terrain
