121213000000000000000000000000000000000000000000000000000000000000000000000000000000000000000000000000000000000000000000000000000000000000000000000000000000000000000000000000111212
1212130000000000000000000000000000000000000000000000000000000000a9000000000000000000000000000000000000000000000000000000000000000000000000000000000000000000000000000000000000111212
1212130000000000000000000000000000000000000000000000000000001a1b1c1d1e1f0000000000000000001a1b1c1d1e1f000000000000000000000000000000000000000000000000000000000000000000000000111212
1212130000000000000000000000000000000000000000000000000000002a2b2c2d2e2f0000000000000000002a2b2c2d2e2f000000000000000040414141414141414141420000000000000000000000000000000000111212
12121300000000000000000000000000000000007f00000000aaabac00003a3b18193e3f000000adaeaf0000003a3b3c3d3e3f00000000c5c6c70050a0a1767751a2a376775200004647474748f0f1f2f3f44041414142111212
12121300000000000000000000000000000000008f00000000babbbc00004a4b28294e4f000000bdbebf1000004a4b4c4d4e4f000000d4d5d6d70050b0b1868751b2b38687520000566557645800000000005060516352111212
12042300000000000000000000c300c400c300009f000aca0b0bcb0bcc0c5a5b5c5d5e5f0acc0b0bce0b20cd0c5a5b5c5d5e5f0a0c00e4e5e6e70050515196975151519697520000565774755840414141425051515152111212
1213000000000000000000010202020202020232353231353130323432333235313431333234323233313430333534323031303134333035323134313233303430343432313435355657848558506c516e525066516952111212
121300000000000709000011121212121212121212121212121212121212121212121212121212121212121212121212121212121212121212121212121212121212121212121213565794955850515151525051515152111212
121300000000000000000011121212121212121212121212121212121212121212121212121212121212121212121212121212121212121212121212121212121212121212121213434444444550707151525051515152111212
121340414142000000000011121212121212121212121212121212121212121212121212121212121212121212121212121212121212121212121212121212121212121212121213536b546f5550a6815152506c516f52111212
121350515152000000000021222222222222222222222222222222222222222222222222222222222222222222222222222222222222222222222222222222222222222222222223535454545550b69151525051515152111212
121350515152000000000000000000000000000000000000000000000000000000000000000000000000000000000000000000000000000000000000000000000000000000000000537273545546474747485051515152111212
12135051265243444500000000000000000000000000000000000000a7a80000000000000000000000000000000000000000000000000000000000000000000000000000000000005382835455566c576d585062516552111212
121346474748532655000000000000000000000000000000001a1b1cb7b8b900000000000000001a1b1c1d1e1f000000000000000000000000000000000000000000000000000000539293545556575757585051515152111212
121356572658404142000000000000000000000000000000002a2b2c2d2e2f00000000000000002a2b2c2d2e2f000000000000000000000000000000000000000000000000000000404141414256747557585051515152111212
12134344444550265200000000000000000000dadbdc0000003a3b3c3d3e3f00000000000000003a3b3c3d3e3f0000dddedf000000007f0000000000000000000000000000000000506851665256848557585068516b52111212
12135354545546474800000000000000000000eaebec00000016174c4d4e4f00000000000000004a4b4c494e4f0000edeeef000000008f0000000000000000000000000000000000505151515256949557585051515152111212
1213535426555626580000070809000000000acdfbcccacc0c5a5b5c5d5e5f0d360e390e360e0ffcfd5c595eff0acf0bfe0b0b0c00009f000d37383939370e0f00c3000000000000505170715243444444444551515152111212
121340414141414142000000000000000000010202023430313533343133333531323435303435303533353431333135323134343533310202020202020202020202030000000000505180815253545454545551515152111212
121350515126515152000000000000000000111212121212121212121212121212121212121212121212121212121212121212121212121212121212121212121212130000000000505190915253547273545551515152111212
121402020202020202030000000000000000111212121212121212121212121212121212121212121212121212121212121212121212121212121212121212121212140300004647474747474853548283615543444445111212
1212121212121212121300000000000000001112121212121212121212121212121212121212121212121212121212121212121212121212121212121212121212042223000056575757575758535492935455536a5455111212
12121212120422222223000007090000000021222222222222222222222222222222222222222222222222222222222222222222222222222222222222222222222300000000566f576257655840414141414253545455111212
121212120423000000000000000000000000000000000000000000000000000000a90000000000000000000000000000000000000000000000000000000000000000000000005657575757575850a4a5767752536e5455111212
121212042300000000000000000000004041414142434444444546474747484041414142434444444546474747484041414142000000000000000000000000000000000040414141425769575850b4b586875253e8e955111212
1212042300000000000000000000000050645165525360546855566a576958506451655253655461555667576b585064516552000000000000000000000000000000000050645165525757575850515196975253545455111212
121213000000000000000000000000005051515152535454545556575757585051515152535454545556575757585051515152000000434444444444450000000000000050515151525763574041414141414141414142111212
121213000000000000000000f5f6f7005070716652537273625556647475585070716652537273665556637475585070716652007f005372735454545500c0c1c200007f507071665257575750767778797a7b7c7d5152111212
1212130000000000000000d4f8f9fa005080815152538283545556578485585080815152538283545556572785585080815152008f005382836954665500d0d1d2d3008f508081515257c8c950868788898a8b8c8d5152111212
12121300c4000000c30000e4e5e6e7005090915152539293545556579495585090915152539293545556579495585090915152009f005392935454545500e0e1e2e3009f509091515257d8d950969798999a9b9c9d5152111212
121214020202020202020202023232323232323232323232323232323232323232323232323232323232323232323232323232323232323232323232323232323232323232323232323232323232323232323232323232121212
121212121212121212121212121212121212121212121212121212121212121212121212121212121212121212121212121212121212121212121212121212121212121212121212121212121212121212121212121212121212
121212121212121212121212121212121212121212121212121212121212121212121212121212121212121212121212121212121212121212121212121212121212121212121212121212121212121212121212121212121212

image image:terrain
hero @5,30
pumpkin @26,30
ghost @23,18
princess @38,6
robot @53,18
clown @49,30
lightbear @47,6
jack @27,18
cat @3,9
pumpkinhat @5,9
jack @32,6
