1212121212121212121212042223000000000000000000000000000000000000000000000000000000000000000000000000000000000000000000000000000000000000000000000000000000000011
1212121212121212120422230000000000000000000000000000000000000000000000000000000000000000000000000000000000000000000000000000000000000000000000000000000000000011
1212121212121204222300000000000000000000000000000000000000000000000000000000000000000000000000000000000000000000000000000000000000000000000000000000000000000011
1212121212042223000000000000000000000000000000000000000000000000000000000000000000000000000000000000000000000000000000000000000000000000000000000000000000000011
1212120422230000000000000000000000000000000000000000000000001a1b1c1d1e1f0000000000000000001a1b1c1d1e1f0000000000000000000000000000000000000000000000000000000115
1212042300000000000000000000000000000000000000000000000000002a2b2c2d2e2f0000000000000000002a2b2c2d2e2f0000000000000000404041414141414141414200000000000000001112
1204230000000000000000000000000000000000000000000000000000003a3b18193e3f0000000000000000003a3b3c3d3e3f00000000c5c6c70050a4a5767751a2a376775200000000000000011512
0423000000000000000000000000000000000000000000000000000000004a4b28294e4f0000000000000000004a4b4c4d4e4f000000d4d5d6d70050b4b5868751b2b386875200000000000001151212
130000000000000000000000000000000000000000000a0b0b0b0b0b0b0c5a5b5c5d5e5f0a0b0b0b0b0b0b0b0c5a5b5c5d5e5f0a0c00e4e5e6e700505151969751515196975200000000010215121212
1300000000000000000000000000000000000030353235343333323232343532353234313433343435333532353333343233313130343334333533353533323233323432333331010202151212121212
1300000000000000000001020202030000000000000000000000000000000000000000000000000000000000000000000000000000000000000000000000000000000000000000210512121212121212
1300000000000000000011121212130000000000000000000000000000000000000000000000000000000000000000000000000000000000000000000000000000000000000000001112121212121212
1402030000000001020215121212130000000000000000000000000000000000000000000000000000000000000000000000000000000000000000000000000000000000000000002105121212121212
12121300000000212205121212121300000000000000000000000000a7a8a900000000000000000000000000000000000000000000000000000000000000000000000000000000000011121212121212
121213000000000000210512121213000000000000000000001a1b1cb7b8b900000000000000001a1b1c1d1e1f0000000000000000000000000000000000000000000000000000000021051212121212
121214020300000000002122222223000000000000000000002a2b2c2d2e2f00000000000000002a2b2c2d2e2f0000000000000000000000000000000000000000000000000000000000111212121212
121212121300000000000000000000000000000000000000003a3b3c3d3e3f00000000000000003a3b3c3d3e3f0000000000000000000000000000000000000000000000000000000000210512121212
1212121213000000000000000000000000000000000000000016174c4d4e4f00000000000000004a4b4c494e4f0000000000000000000000000000000000000000000000000000000000002122222205
12121204230000000000000000000000000a0b0b0b0b0b0b0c5a5b5c5d5e5f0a0b0b0b0b0b0b0c5a5b5c595e5f0a0b0b0b0b0b0c00000000000000000000000000000000000000000000000000000011
1212042300000000000000000000010330353432353235343532333333333334353434353232343435353234353434353434353435323100000000000000000000000000000000000000000000000011
1204230000000000000007090000212300000000000000000000000000000000000000000000000000000000000000000000000000000000000000000000000000000000000000000000000000000011
0423000000000000000000000000000000000000000000000000000000000000000000000000000000000000000000000000000000000000000040414141414200000000000000000000000000000011
1300000000000000000000000000000000000000000000000000000000000000000000000000000000000000000000000000000000000000000050a0a176775200000000000000000000000000000011
1300000043444444454041414142000000434444444546474747484041414142464747474800000040414141424344444445404141414200000050b0b186875200000000000000000000000000010215
130000005366546355506c516e520000005361546e5556665767585067516552566d5763580000005061516852536e546a55506e516c5200000050515196975200000000000000000000000000111212
1300000053545454555051515152000000535454545556575757585051515152565757575800000050515151525354545455505151515200000040414141414141414141420000000000000102151212
1403000053727354555070715152000000537273545556747557585070715152567475575800000050707151525372735455507071515200000050767778797a7b7c7d7e5200c0c1c200001112121212
1213000053828364555080816952000000538283625556848564585080816f525684856e5800000050a6816f5253828366555080816b5200000050868788898a8b8c8d8e5200d0d1d2d3001112121212
1213000053929354555090915152000000539293545556949557585090915152569495575800000050b69151525392935455509091515200000050969798999a9b9c9d9e5200e0e1e2e3001112121212
1213303432343533353433343235353334323534333235333433343233323233353334343535323532323434353435323533333535323435353532353434323434343334353232323030301112121212

image image:terrain
